C C C C C C C C C C C
C B B D B B B B B B C
C B C B C B C B C D C
C D B B B B B B B B C
C D C B C B C D C D C
C B B B B B B D D D C
C B C B C D C D C D C
C D D B B B B B B B C
C B C B C B C B C B C
C C C C C C C C C C C